################################################################################################################      
##########################............................................................##########################     
##########################............................................................##########################    
#########################..............................................................#########################
#########################..............................................................#########################
########################................................................................########################
#######################..................................................................#######################
#######################..................................................................#######################
######################....................................................................######################
######################....................................................................######################
#####################......................................................................#####################
#####################......................................................................#####################
####################........................................................................####################
###################..........................................................................###################
###################..........................................................................###################
##################............................................................................##################
##################............................................................................##################
#################..............................................................................#################
#################..............................................................................#################
################................................................................................################
###############..................................................................................###############
###############..................................................................................###############
##############....................................................................................##############
##############....................................................................................##############
#############......................................................................................#############
#############......................................................................................#############
############........................................................................................############
###########..........................................................................................###########
###########..........................................................................................###########
##########............................................................................................##########
##########............................................................................................##########
#########..............................................................................................#########
#########..............................................................................................#########
########................................................................................................########
#######..................................................................................................#######
#######..................................................................................................#######
######....................................................................................................######
######....................................................................................................######
#####......................................................................................................#####
#####......................................................................................................#####
####........................................................................................................####
###..........................................................................................................###
###..........................................................................................................###
##............................................................................................................##
##............................................................................................................##
#..............................................................................................................#
#..............................................................................................................#
#..............................................................................................................#
############################........................................................############################49
############################........................................................############################
############################........................................................############################
############################........................................................############################
############################........................................................############################
############################........................................................############################
############################........................................................############################
############################........................................................############################
############################........................................................############################
############################........................................................############################
############################........................................................############################
############################........................................................############################
############################........................................................############################
############################........................................................############################
############################........................................................############################
############################........................................................############################
############################........................................................############################
############################........................................................############################
############################........................................................############################
############################........................................................############################
############################........................................................############################
############################........................................................############################
############################........................................................############################
############################........................................................############################
############################........................................................############################
############################........................................................############################
############################........................................................############################
############################........................................................############################
############################........................................................############################
############################........................................................############################
############################........................................................############################
############################........................................................############################
############################........................................................############################
############################........................................................############################
############################........................................................############################
############################........................................................############################
############################........................................................############################
############################........................................................############################
############################........................................................############################
############################........................................................############################
############################........................................................############################
############################........................................................############################
############################........................................................############################
############################........................................................############################
############################........................................................############################
############################........................................................############################
############################........................................................############################
############################........................................................############################
################################################################################################################