################################################################################################################     
###########################..........................................................###########################     
###########################..........................................................###########################    
##########################............................................................##########################
##########################............................................................##########################
#########################..............................................................#########################
########################................................................................########################
########################................................................................########################
#######################..................................................................#######################
#######################..................................................................#######################
######################....................................................................######################
######################....................................................................######################
#####################......................................................................#####################
####################........................................................................####################
####################........................................................................####################
###################..........................................................................###################
###################..........................................................................###################
##################............................................................................##################
##################............................................................................##################
#################..............................................................................#################
################................................................................................################
################................................................................................################
###############..................................................................................###############
###############..................................................................................###############
##############....................................................................................##############
##############.........................................#..........................................##############
#############.........................................#.#..........................................#############
############..........................................#.#...........................................############
############.........................................#...#..........................................############
###########..........................................#...#...........................................###########
###########.........................................#.....#..........................................###########
##########..........................................#.....#...........................................##########
##########.........................................#.......#..........................................##########
#########.........................................#.........#..........................................#########
########..........................................#.........#...........................................########
########.........................................#...........#..........................................########
#######..........................................#...........#...........................................#######
#######.........................................#.............#..........................................#######
######..........................................#.............#...........................................######
######.........................................#...............#..........................................######
#####..........................................#...............#...........................................#####
####...........................................#...............#............................................####
####...........................................#...............#............................................####
###............................................#...............#.............................................###
###............................................#...............#.............................................###
##.............................................#...............#..............................................##
##.............................................#...............#..............................................##
#..............................................#...............#...............................................#
##.............................................#...............#..............................................##49
##.............................................#...............#..............................................##
###............................................#...............#.............................................###
###............................................#...............#.............................................###
####...........................................#...............#............................................####
####...........................................#...............#............................................####
#####..........................................#...............#...........................................#####
######..........................................#.............#...........................................######
######..........................................#.............#...........................................######
#######..........................................#...........#...........................................#######
#######..........................................#...........#...........................................#######
########..........................................#.........#...........................................########
########..........................................#.........#...........................................########
#########..........................................#.......#...........................................#########
##########..........................................#.....#...........................................##########
##########..........................................#.....#...........................................##########
###########..........................................#...#...........................................###########
###########..........................................#...#...........................................###########
############..........................................#.#...........................................############
############..........................................#.#...........................................############
#############..........................................#...........................................#############
##############....................................................................................##############
##############....................................................................................##############
###############..................................................................................###############
###############..................................................................................###############
################................................................................................################
################................................................................................################
#################..............................................................................#################
##################............................................................................##################
##################............................................................................##################
###################..........................................................................###################
###################..........................................................................###################
####################........................................................................####################
####################........................................................................####################
#####################......................................................................#####################
######################....................................................................######################
######################....................................................................######################
#######################..................................................................#######################
#######################..................................................................#######################
########################................................................................########################
########################................................................................########################
#########################..............................................................#########################
##########################............................................................##########################
##########################............................................................##########################
###########################..........................................................###########################
###########################..........................................................###########################
############################........................................................############################
############################........................................................############################
################################################################################################################
